1111111111111111
1       1      1
1   111111  1111
1           11 1
1   111    1   1
1   1      11  1
1   11   1     1
1   11  11  1111
1   11  1      1
1              1
1   11111  11  1
1       1      1
1    111111   11
1 11     1     1
1  1     1     1
1111111111111111